          #$$&                                      --*((**)(((())))*((*******((***)(),        !
         #***)&                                       ,,*-**((('*****(((*****(())))(,)         !
 #$$$$%%$$*,,++%&                                       - ,,)))()()()())))))(())))))((         !
 ,,,,,,,-,-  ,,,-                                           ,,))))()'))))))'))))))))('         !
                    #$$$$()*(&               #$$%$&           ,)))))))))))))))(()),)))&        !
                    (***(())),               '))***)&         ",+))))'))))')))(()))))))%%%&    !
                    *'***))+,                ')))))))$&       ! '))))))))),)'((,,)))))))(((%&   
                    (*****)-                 -))))(())%&      ! ))()())))+#))(( .,(((((((((((%& 
%$$$$$$$%%%%%%%$$$$$((((()-                   ,-)'(()'(%&     ! )(('()))),())+,.  (()))((())((((
(),)(((),'()((((((((()'))-                     .--)))(()(     ! )((()))))))(,,    ,))))))(((((('
(+#)'((,#())))(()(,(),'),                        .--)-)))&    ! ,)())))))()+      .,,,,)))))),((
)),))(, -,-))'),)).', ,, .                         .- ))'%&   ! .)('))+))'(-          .,,,,,,.,)
,,.,,, . . ,-,, -, , .                              . -,))*%& !  ,))())))((&            .      ,
              .                                         ,+-,, !  #)()))'((()                   .
                                 22222222222222          -    !  )(())))(())                    
                                 33333333333333               !  ,)+),))())(                    
                            #$%%&44444444444444$%&            !   ,)+ ,))))(                    
%%%$$$$$$%%%%%%%%%%$$$$$$$$$)))($$$$$$$$%%%%$$$)))$%%&        !    )- .,)),-      #%%%$$$$$%%%%%
)(()))()(())')))))())))******)))())*************()***)&       !    ,.   ,,      #$)(')))(())))()
(()))(('(())))))))()'))()((((((('(*******))()(((),)**)(%%%&   !            .    ,))(),)()')))()(
)')))((()))')))(('))))))(')()*****)()(()),,,(,))- ,,,,****,   !                  ,,,, ,,)')('))(
)),)())))))))))((())(())'(,,)-)'(+,-,+,,,.  ,,,, .  . ,,,,    !                      . ",+))))))
),))(,)))())))'(()),,)))(). , ))), ! ,.        .              !                        ! ,,()),)
, ,,- ,))())(((()), .,))),   .)),. "                          !                        !  .,), ,
  . !  )))))'),)),.   ,)).    ),   "                                                   !    ,  .
    ! .)')))(( -)      +,     + .  !                          #$$$$$$%%%&         #$%& "        
    "  ,)))(),  -.     -      -    !    0$$$$$$$$$%%%%%%%$$$$$)))(())))),         ,)(( !        
    "   ,))(,                      !   0)))))*********)(()))))))(())))(,           ,,- !        
    !   .))).                      "  0)***())))'(()))'()-)(,,)((())'((                !        
    !    )+,                       ! 0)()))))-,)((,)()((, )-  )()))))()&               !        
    !    )-                        ! ))(**),,  )), -+,,,  , .#))))((('))%%%&           !        
    !    -                         " )(((')  . ,-   , .      ,,))(())()))+))&                   
    "                              ! ,)((),                   .,,,,,,,)))))))%%%%%$$$$$$%%&     
    !                                 )**(                        .   ,,,-,))))()(()))))(((&    
%%& !                                #))'(&                               .,*))('()+)))')()))%%%
)(- "                              #$))(())&                                ,),)))),)(((,))))(()
))  !                      #$$$$$%%))()())))%%$   %$$$$%%&                   ,.,,,, ,)), ,,+)'()
)+                       #$)(())()))'()))'((())   ))))))))%&                       . ,-   !)((),
),                     #$$)()),())(()+)))('()),   -,-)+-))))%&                            "-+)))
)))$$$$$$$%%%%%%$%%$$$$)*---,-,,,),,---))))-,-      .-, +--()$$%$$%%%%$$$$&               ! ,)))
(*****((*))(())))(()),,-,    . . -  ! .-,-,  .         .,  ---------)))))))&              " !,))
()**())))))()')())),,    .          !    .                          +)))))))%&            ! " )(
)))*(*)))()()))))))                 "                         . .   ,)))))))(()%%%$$$%%%& ! " -)
')((()())))))))()                   !                                )))))))())))())))((( " ! !)
)))(())')))))))))                   !                                )()))))))*((()))))(( ! ! !)
)+,))))))+)))))))))%%%%$$$$%%%%%%%& ! #$%$$$%%%%%$$$$$%%%%$$$%%%%&  #))+)((((+,**)'))))() ! ! !,
)- ,)')))))))))))(())))))))())))(), ! ,)))))))))))))))))))))))()(,  ,))-*()**, ,*****()))   " " 
+ . )))))))))((,)(')),,,)(('))()),  !  )(,))),+)(),,))()),,,((),,    ,, **+,, . -+,,,*))(&  ! " 
,   ,)))))),,,, ,,),,. .,,,))),,,   "  ,,.,,,.,,),. ,()+, . ,)(.        ,,, .   .,  .,*(()  ! ! 
    .,))((,       ,        ,,,.     "      .    ,   .,,-     ,,                       ,())    ! 
      ))((                          !                  !                               *))    ! 
     .-(('                          "                  "                               ')(    ! 
       )((                          !                  "                               *((    " 
       ,()&                                            !                              #))(&   ! 
        )$%%%$$$%%%%%%%$$$$$$$$$$$$$$$$$$$$$$%%%%%%%&  !  #$$$$%%%$$$$$$$$$$$$$$%%%%%$$)))(   ! 
        -,)+,-),)(()((((()))()(()))),))))+))))()(()))& " #))))))(()))(()))))))())')(())))((   ! 
          -, !,))()))(('))))('()))')())'),))(((()))))+ " *))'))))'))((),)'))(,)))))(())))()   ! 
             ! *(('*)((*****(*,-,,,***,,*#**(,)**,**+, ! ,,,+,,,,,,((,,,,-,,+,-,,,((**))()(     
             " ,*'),)(,,,+***,  .  ,,-  ,**,,.))**+*,  !   ., .  . ,, .    .,.  . -***(-)))%&   
             !  ,*).--  .,*,-      .   . *,.  ,,))+,.  "                           **(( ,,+(*$%&
&                +,       ,.             ,      ')(    !                           ,)(-  .)+,-((
,                ,                              ))*%&  !                          #**(    ),  ,,
                                                ,)(**&                            **))&   ,    !
                                                 ,,,*)%%%$$$$%%%%%%%%%%$$$$$$$$%%%)*)))        !
