))))))))))))))))))))))))))))))))))))))))))))))))))))
))))))))))))))))))))))))))))))))))))))))))))))))))))
))))))))))))))))))))))))))))))))))))))))))))))))))))
))))))))))))))))))))))))))))))))))))))))))))))))))))
))))))))))))))))))))))))))))))))))))))))))))))))))))
))))))))))))))))))))))))))))))))))))))))))))))))))))
))))))))))(()))))(())((())))))(((()))(())()))((())))
))))((()))))))((())))))(()))((()))))))))))))))))((((
()))))))))))))))((()))))(((()))((((()))((())(())))))
((()))()(())))))))))(()))--,-,,)))))()(((()))))))(((
))))(()))))))((())(***)*-././/.-)))))))))((())()(())
())))))))()))))))*((')),/    .//,--*((*()*))))))(())
))))((()))((())))***),,.         ..--****))((*)))))+
)))))))))))))((()***).              .,,,)))**)))*+**
)()))(())))))))))**(,/                ./-(((((*(*(**
))))))))))((())(((*(/                   /,,,,,((((*(
(()((())()))))))***(.                     .//.,,,,(*
)))))))))))(())))*(,/                         ////'(
()))))()())))(())+(.                              '(
**))))))))((())*)+(/                              ')
())())))))))))))(((                               ')
)))))))(((()((())*(&                              ')
))))))))))(()))*)))$$$%%%%%$$$$$$$$$$$$%%%%%%%%%%%)(
)))(((())))))))))(())))))))))(())))))))))())))))(())
)())))))))))((((()))(*)))(())))())()())())))((()))))
)))()))())))))))))))))(()))))))))))(()))()))))))))((
))))))))())()())))()))))))))()))()))))))))))))))))))
))))))))))))))))))))))))))))))))))))))))))))))))))))
))))))))))))))))))))))))))))))))))))))))))))))))))))
))))))))))))))))))))))))))))))))))))))))))))))))))))
))))))))))))))))))))))))))))))))))))))))))))))))))))
))))))))))))))))))))))))))))))))))))))))))))))))))))
))))))))))))))))))))))))))))))))))))))))))))))))))))
))))))))))))))))))))))))))))))))))))))))))))))))))))
))))))))))))))))))))))))))))))))))))))))))))))))))))
))))))))))))))))))))))))))))))))))))))))))))))))))))
))))))))))))))))))))))))))))))))))))))))))))))))))))
))))))))))))))))))))))))))))))))))))))))))))))))))))
))))))))))))))))))))))))))))))))))))))))))))))))))))
))))))))))))))))))))))))))))))))))))))))))))))))))))
))))))))))))))))))))))))))))))))))))))))))))))))))))
))))))))))))))))))))))))))))))))))))))))))))))))))))
))))))))))))))))))))))))))))))))))))))))))))))))))))
))))))))))))))))))))))))))))))))))))))))))))))))))))
))))))))))))))))))))))))))))))))))))))))))))))))))))
))))))))))))))))))))))))))))))))))))))))))))))))))))
))))))))))))))))))))))))))))))))))))))))))))))))))))
))))))))))))))))))))))))))))))))))))))))))))))))))))
))))))))))))))))))))))))))))))))))))))))))))))))))))
))))))))))))))))))))))))))))))))))))))))))))))))))))
))))))))))))))))))))))))))))))))))))))))))))))))))))
))))))))))))))))))))))))))))))))))))))))))))))))))))
))))))))))))))))))))))))))))))))))))))))))))))))))))
))))))))))))))))))))))))))))))))))))))))))))))))))))
))))))))))))))))))))))))))))))))))))))))))))))))))))
))))))))))))))))))))))))))))))))))))))))))))))))))))
))))))))))))))))))))))))))))))))))))))))))))))))))))
))))))))))))))))))))))))))))))))))))))))))))))))))))
))))))))))))))))))))))))))))))))))))))))))))))))))))
))))))))))))))))))))))))))))))))))))))))))))))))))))
))))))))))))))))))))))))))))))))))))))))))))))))))))
))))))))))))))))))))))))))))))))))))))))))))))))))))
))))))))))))))))))))))))))))))))))))))))))))))))))))
))))))))))))))))))))))))))))))))))))))))))))))))))))
