'''''''('''''''''''''''''''''''''''''''''(  !                                                                        !                     !   ('''('''(                !                             '        ''(            !           !                     +++++++++                                        ''''''('(''''''
(('''((''('('''('(''''''('('('''(''('''('   !                                                                        "                     !     ((''(*                 !                                      (''&           !           !                    +,,,,,,,,,+                                         '''((''''('''
( ''''('''( ''''(''''''('''(''''('(''''((   !                          #$$$$$$$$$$$$$$$$$$$$$$$$$$$$$$$$$$$$$$$$$$$& !                     !         ()                 "                                     #'(''           !           !                  #$$$$$$$$$$$$&                                         '(   ''(''('
  '''(  '(  **'( '('''(('**''''('( '''('    !                            '('''''''''''''''''''''''''''''''''''''''   !                     !                            !                                     '''''           !                               '''''''''''                                           *     '(( '(
   '    '   ))*  ''(''('*))*''''(  **''(    "                              ( (''('''''('''''('''('''''''(''''('((    !                     !                            "                                     '''''$$$$&      ! #$$$$$$$$$$$$$$$$$$$$$$$$$$$$$'(''''(''''                                           !     '   ' 
   '          )    ('''()  )''(    ))'(     !                                  ( ''('''('('('''(''''('('''('('(      !                     !                            !                                       *''''''       !  '''''''''''''''''''''''''''''''((''(''                                             !           
                    (''(     '       *      !                                     (''( ''( ('''('('''( '* (( '(      "                     !                                                                    !*''''(       "   ''''''((''''''(''('''('' '(''''('('(                                              !           
                     '               )      !                                           '    '('''''    !            !                     !       #$$$$$$$$$$$$$$$$$$$$$$$$$$&          #$$$$$$.               !)'('''       !      (''' ('' (   (''''(    (''(( '''(                                              !           
                                            !                                                  '''('    !            !                     !          '''''''''''''''''''''''              ''''''.              ! '''('               ''(  '        ''(      ''(  ''''                                              !           
                                            !                                                  ('''(    "                                  !           (('('''''('''''''(''(                '(''''.             ! '('''$$$$$$$$$$$&   '(            ''            ((''$$$$$$$$$$$$$$$$$$$$$$$$$$$$$$$$$$$$$$$$$$$$& !           
                                            !                                                   '''     !                                  !            ( (('('( ''(''(' ((                  ('''''.            !   (('''''''('''     '             *              (''''''''''''''''''''''''''''''''('''''''''('(   "           
                                                                                                ''(     "            #$$$$$$$$$$$$$&       "                '((   (('''(                     ('(''''$$$$$$$$$$& ! #$''('('((' (((                   !               ('('''(''(''''('('('''('('('''(''('('''('( (    !           
                                                                                                ''      ! #$$$$$$$$$$''''''''''''''        !                 (      ('(                       (''''(''''('''''  !  ('( ('''(( (                     "               ''''((  ( ('''(  (((''( (  (* ((   (( '(        !           
$$$$$$$$$$$$$$$$$$$$$$$$$$$$$$$$$$$$$$$$$$$$$$$$$$$&                 #$$$$$$$$$$$$$$$$$$$$$$$$$$''      !  '''''''''''''(''''''''''$$&     "                                                   '(''''''''''''(  !   (   '( (                        !               ((          ((    ((((      !                   ! #$$$$$$$$$
('''('''('(''''(''''''''('''(''''''''''''''''''(''                    ''''''''''('''''''''''''''''      !   ''''(''('''''''''''('(''''     !                                                    '''''('''('(''  !                                   !                                           !                   !   ('''('''
'''(''(''* (''''('''('*'''*'('(''(''''''('''((''(                     (''''('((''((''(''''''''(' (      !    ''(''''(('''('''(''(''''($$$& !                            #$$$$$$$$$$$$$$$$$$$&   '(''''('(''(((  !                                   !                                           !                   !     (''('(
''''(''( )   ('('''('*)'( )  (''''('('(''( (  '(                        ''''(  '(  (( '('(''('(         !    ''( ('( ( ''('(''''''''('''   !                              '''''''''''''''''     * ''('(''(( (   !                                   !                                           !                   !      ('   
 '(  '        (  '''() (      ( '(  '( '(                               '*('          (''('''(          !    '(        (' **'(''('''''(    !                              ('''''''''''''''(     ! (' ( '        !      #$$&                         ! #$$$$$$$$$$$$$$$$$$$$$$$$$$$$$$$$$$$$$$$& !                   !       (   
                  ('                (               #$$$$$$$$$$$$$$$$$'''!'(           (  ('            !    '          ' ))**(''''''('    !                                (''('''''(''(       "  (            !       ''                          "  ('('''''''''''''(''('''''''''''''''''(   "                   !           
                                                      ''''''''''''''''''(!                              !                   ))*'(''''''    !                                 ('''''''''(        !               !       ''                          !      ('('''('('''((( (('''('('('''("((    !                   "           
                                                #$$$$$'('''''''''''''''('!           /0123              !                     )  (''('(    "                                   ('('('(          !               !       ''                          "       ((''''(((''(     ('( ( (''('(!      !                   !           
                                                 '''''''''('''(''''('''' !                              "                        '''((     !                                    *'''*           !                      #''&                         !         ( '(   '(       (    (  (  !      !                   !           
                                            #$$$$''(''(''('((''''(''''(' "                              !                        '('       !                                    )''')           ! #$$$$$$$$$$$$$$$$$$$$''''$$$$$$$$$$$$$$&          !           '    (                   !                                      
$$$$$$$$$$$$$$$$$$$$$$$$$$$$$&               '''('''''('('' (''(' ('''(' !                              !                        '''                                             '''            "    ''''''''''''''''''''''''('''''''''(            !                                    ! #$$$$$$$$$$$$$$$$$$$$$$$$$$$$$$$$$$$$
''(''''('''('''''''('''''''                    '''''(''(           ''(   !                                                       '''$$$$$$$$$$$$$$$$$$$$$$$$$$$$$$$$$$$$$$$$$$$$$'''$$$$$$$$$$& !     ('(('(''(''(('('''('('''(''''(''''            !                                    !    '''''''''''''''''''''''''''''''''(
'''(''('(''(''('''''''('(                        *('(               '    ! #$$$$$$$$$$$$$$$$$$$$&               #$$$$$$$$$$$$$$$$'(''''(''''''('''''''''''('''''''''''(''''('''('('''('''''('   "        ((''(('(  *('( **'''('(''((('((            !                                    !      *'('''(''''('(''(''(''''(''(''('
'( ''((  ('****''('(''(                          ! '(                    !   ('(*'''''''''(''''                  '''('('''('''(''(('(''(''('(('''''(''('('''('('''('''''''(''''''((''''(''''    !         (('' '   ) '( ))''(('''('''('             "                                    "      )   ('''('( '''( '''((''''( (''(
    '     *)))) ''( '(                           !                       !    ( !(''''''''''('(                  ''''(''(''''(''(( (''((''' ( '(''( ''((''((  '''((''((('('''('''( ''(((('((    !          ('' (     (    ('' (''''(''(             !                                    !             (      (   ((   '(   (  (
          )     (                                "                       !      " ((''('*'((                     ''* '('('( (**(   ''(   '(     '    '   ''   *('(''(  '(  '(''(   ''(   '(     !            *            ''((('( ''''              !                                    !                                      
                               +++++++++++++     "                       "      !  ( '(()                        '(!  '  '   ))     '    '                '   !'   '   (      '     '           !            !            '(   (  ('((              !                                                                           
                              +,,,,,,,,,,,,,+    !           ++          !      !                        #$$$$$$$' !     '                                    !'              *                 !            !                    ('''                                                                                          
                             +,,,,,,,,,,,,,,,+   !          +,,+                !                          ''''''' !                                          !               !                 !            "                     (''$$$$$$$$$$$$$$$$$$$&     #$$$$$$$$$$$$$$$$$$$$$$$$$$$$$$$$$$$$$$$$$$$$$$$$$$$&            
   #$$$$$$$$$$$&        #$$$$%%%%%%%%%%%%%%%%%$& !    #$$$$$%%%%$$$$$$$$$$$$$$& !                           (''('( "                                          "               "                 !            !                     '''''''('''''''''('''         ''''('''''''''''('''''((''''''''''''''''''''''(*'              
     '(''''(''            ''(''''(''''(''''''''  !      ''''('''''''''('''''''  !                           (''('  !                                          "               !                 "            !                       ''('''(''''(''('('          '''('''''''('''('''''''('('''''''(''(''''('('('!(              
        '(''(             **'(''''''(''''('''((  !      '''''''''(''('''('''(   !                            '(((  !                                          !               !                 !            "                       ''('''''''(''''''(           ''(''''('''('('''''''''(''''''''''(''('''(' ('!               
          '(              )) ((''('(''''''( '(   ! #$$$$'(''''('(''(*'(('''(    !                            ((    !                                          !               !                 !            !                        '('''(''('''(''('           '('***''('('(((((''(('''''''((((('''('''*    '!               
++        '                    (''   (''(   (    !   ''''' ('''( ''*)(  ('''    !                            (     ! #$$$$$$$$$$$$$$$$$$$$$$$$$$$$$$$$$$$$$$& !               !                 !            !                         '(''''(('''(('             '''))!'(   (   (( (' (('''((      (((''()     !    +++++++++++
,,+                             ('     *    (    "    ''(    '(( (')     ('(    "                                  !   ''''''''''''''''''('''''(''''('''(('   !               !                              !                         ''''(('(''(((               '(  !'                 (         (   '       !   +,,,,,,,,,,,
%%%$&                                  !         !    ('     (    (       (     !                                  !    ''(''''''''''''''''(''(('''((''''(    !               ! #$$$$$$$$$$$$$$$$$$$$$$$$$$& !                           '''''('(*                     !                                        ! #$%%%%%%%%%%%%
'''                                    "         !     (                        !                                  "      ''''''''(''(''('''((   '(   ('(     !               "  ''''('''''''''''''''''''''  !                           '''''''()                     "                                        !   ''''''''''''
'(                                     !         !                              "                                  !       ('''('''(( '  ('( (                !               !    ''''('''('(''''''(''''(   ! #$$$$$$$$$$$$$$$$$$$$$$$''''''''''                      "                                        "    ''''('*'''(
(                                      !         "                              !                                  !         '''('(       '                   "               !     ''('''''(''''('''(''((   !   ''''''''''''''''''''''''''('(''*                      !                                        !     (''(*)('('
                                       !         "                              !                                  !          ''''(                           !               !      (('(''(''('(''('('''    !    ((''(''('('('(''('('('((''(''()                      !                                        !      '( )  ( '
    #$$$$$$$$$$$$$$$$$$$$$$$$$$$$$$$$& !         !                                                                            '''(                            !               !         ''( ''(( (' ( ('(    !       ('''((( '''(( ''(   ('(''''                       !                                        !               
      ''''''''(''''''''''('''''''''!   !         !       -$$$$&                                                               '''                             !               !          '( ('(   '    *     !         '(     '(   ('(    ((''''                       !                                                        
       ((''''''''''(''('(''''''('( !   !         !      -'''''                                                                 ('                                                        '             !     "                              '''(                       ! #$$$$$$$$$$$$$$$$$$$$$$$$$$$$$$$$$$$$$$$$$&            
          '(''''('''((**  (''''(   !   !         !     -''''(                                                                  ''$$&     #$$$$$$$$$$$$$$$$$$$$$$$$$$$$$$$$$$$$$$$$$$$$&                !     !                                ''$$$$$$$$$$$$$$$$$$&    !    '''''''''''''''(''''''''''''''''''''*               
          ('''''('( ( ))   ('(     !   !              -''''('      #$$$$$$$$$$$$$$$&                                           ''''        '''('''''''''''''''(''''''''('''''''''''''                  !     !                                ''''''''''''''''''''     !     (''('''''('(''''''''''''('''('''('(!               
            ''(             (      !                 -''''''(        ''''''''*''''                                             (''(        * ('''((''''('((''''(('(''(''''((''(''('(                   "     !                             #'''''''''''('''('''''      !      ('''(''''' ('('''(''((('''''(''(  !               
                                   ! #$$$$$$$$$$$$$$$''('('(           ''('  !(                                                 ('         !  (''' (''('(   ''(  (  ''('''( '(''''(                    "                                 #$''''(''((''''''(''''''      !        *'('('(   (''''' ((    ''''(    !               
                                   !    ''''''''('''''(''(((            '(   "                                                   (         !    '(   ' (    ('       '  '(     ''(                     ! #$$$$$$$$$$$$$$$$$$$$$$$$$$$$$$$'''((((((  ***** ''(''''      "        )( '(       (''(       ('(      "               
                                   "   ''(''''(''('(''('                (    !                                                             !         (                  *      ('                      !   '(''''''''''''(''''''('''''''''*('(   (  )))))   (('''      !                                (       !               
                                   !    '(('''''''(('                        !                                                             "                            !           #$$$$$$&           !    ('''''''('(''(''''''''('('''''! (                ('('      !                                        !               
$$$$$$$$$$$$$$$$$$$$$$$$$$$$$$$$$& !     (('*'((''(                          ! #$$$&                                                       !                            !             '''(             !     ((''''''(''''(''('''(((''(''("                   '''      !                                        ! #$$$$$$$$$$$$$
'''''''''''''''''''''(''''('''('   !        !  ('                            ! ('''($$$$$$$$$$$$$$$$$$$$$$$$$$$$$$$$$$$$$$$$$$$$$$$$$$$$$& !                            "             ''''             !      ''''(''( ''((((''('(  '(''((!                   (''      !                                        !   ''''''''''''
'('''('('''('''(''('(''('('''(     !        !                                !   (('''(''''''''''(''''''''''''''''''''''''''(''''''''''(   !                            !             ''''             !        ''('(  '(     * (   ( '(' !                    ''                                               !   ''(''('''''(
' ('''(''(('(''''(' (  ( ( '(      !        "                                "      (''''(''('''('''(''''(''('''(''('(''(''(''''(''(''(    !                            "            #'*('&                     '''           !       ((( !                    ''$$$$$$$$$$$$$$$$$$$$$$$$$$$$$$&                !   ('(('('''(*'
*  ('((  (  ( ''                   !        !                                !       (''('''''(('(*''''((  ''''''(''('''''('''(''(''((     !                            ! #$$$$$$$$$$'')'''$$$$$$$$$$$$$$$$$$$'''''           !           ! #$$$$$$$$$$$$$$$$$$''''''''''''''''''''''''''''''                   "    (  ('(''()*
)                                  !        !      #$$$$$$$$$$$$$$$$$$$$$$$& !         (('''('((  )**''(    (''((  ( ''' ((((''(  ( (      !       #$$$$$$$$$$$$$$$$$$& !   ('(''''''''$'''''(''''''''''''''''''''*           !           !     '''''''''''''''''''''(''''''''''''('''''''('(                   "         '(   )
                                   "        !         '''''''''''(''''(''    !           ''''((    ))'        '(     *'(     '(            !         (''''''''''''''('  !     (('''('('(''('((('(''('('('(''''(''()           "           !     ((('''('''''('''(''''((''('''('''(('''(('''(                    !               
                                   !        !          ''('((''((''''''(     "            '(         (               !                     "         '(''''(''''('((    !       ((''''(('''(   ('''('''(( ('''''('            !           !       ''('''('''( ''((''(  '(' ''''('(  ''''(((                     !               
                                   !        !           '((  **  (''((       !                                       !                     !         ''''('('('''(      !         ('((   ('(    ('( ('''   ('('(''            "           "           ((   (   (       (    (   (   ( ( ((                      !               
                                            !            (   ))     (        !                                       !                     !          ''''*((('**       !          (             (   ''(    '( '''            !           !            (                                                                        
$$$$$$$$$$$$$$$$$$$$$$$$$$$$$$$$$$$$$$$$$$& !                                !                                       "                     ! #$$$$$$$$''(')   ())       !                            ('(    (  '''            "           !                                                                    #$$$$$$$$$$$$$$$$
