'$$$$$$$$$$$$$$$$$$$$$$$$$$$$$$$$$$&    ('    "            '( ' (    "    '                                              " ('  !           ('(                                            !  '''
'''''''''''''''''''''''''''''''''''           !                      !                                                   ! ''  !            '               #$$$$$$&            #$$$$$$$& !  '''
'''''''''''''''(''''''(''('''''''''           !                      !                                                   ! ''  !                             ''''('              '''''''  !  (''
'''''''''''(''('''('''(((''''('(''(           !                      !                                                   ! ('&                                (''                  ''('(  "  '('
'''('''(''''(  ('( (''(   ('''' ''            !                      !                                                   !  ''$$$$$&                           '(                  (''(   !  '''
'('''''( ''(    '   '(     (''( ('            ! #$$$$$$$$$$$$$$$$$$& ! #$$$$$$$$$&                          #$$$$$$$$$$& !   (''''''$&++++++++++++++++++       (                    *     !  '''
'('''((   '                 ('   (            !   '''''''''''''''(   !   ''''''''                             '''''''''  !   ((''''''',,,,,,,,,,,,,,,,,,+                           "     !  '''
(  '                                          !    '('('''''('''('   !    ''''('(                              ''('''(   !     (''('''$$$$$$$$$$$$$$$$$$$$&                         "        '('
   *                                          "    '( ('((''''('(    !     '(('(    ++++++++++++++++++++++     ('''('(   !      '* '('''''''''('''''''''''                          !      #$'''
   !                                          !         ''''('(      "      '(     +,,,,,,,,,,,,,,,,,,,,,,+     ('(((    !       !  '('''''''('''''(''(''(           ++++++++++++   !    #$'''''
   !                                          !           '(''(      !      '     #%%%%%%%%%%%%%%%%%%%%%%%%$&   (''      "       "   ''''(''('''''( (  (            +,,,,,,,,,,,,+  !    '''''''
   "                                          !              '       "              '''''''''''''''''''''((      '(      !       !    ''''('''(''''        #$$$$$$$$$$$$$$$$$$$$$$& ! #$$('''''(
   !                                                                 !               ((''('('''('(('('(                  !       !     '''('( ('('(          ''('''('''''''''(''''' !  (''''''''
$& ! #$$$$$$$$$$$$$$$$$$$$$$$$$$$$$$$$$$$$$$$$$$$$$$$$$$$$&          !                 ( '(( '''((  '(                           "     ''''(   ''             (  '  '(''(''(''''('  !   (''''(''
'  !   '''''''''''''''''''''''''''''''''''''''''''''''''             !                   (    '(                                 !     (''      *                *    (''(''(('(    "    ''(('''
'  !     ''''(''''(''''''(''''('(''''''((''('''''(''('(              !                                           -$$$$$$$$$$$$$& !     '''      !                !      (('' (      !    (''('''
'  !      ((''('''('('''''''('(''''''('' (  *'(''' (                 !                                          -'''''''''''''   !     '''      !                "        '         !    ''''''(
'  !        (( ('' ('''(''('( ('('''''(     !''                      !                                         -''''('''''('(    !     '''      !                !                  !      '''''
'  !        (    (  (''''(      '''('(      !                        "                                        -'''''(('('''      !     ''(      "                !                         (('('
'  !                   '(        (''        "                        !        #$$$$$$$$$$$$$$$$$$$$$$$$$$$$$$$''('('( '('((      !    #'''      !                !            #$$$$$$$$$$''''(''
'  "           /0123              '(        ! #$$$$$$$$$$$$$$$$$.    !         '''''''''''''''''''''''''''''''''''('    '(       !    ''''      ! #$&            ! #$$$$$$$$$$''''''''''''''''''
'  !                                        !   '''('''''''''''''.   !          ('''''''''''''''''''(''''''''('*('               !   #'''       !  ''$&          !  ''''''''(''''''(''('''('''('
'  !                                        !    (('('''''''('''''.             '''''''''''''('''''''''''''''('"                 "  #'''(       !   ('(          !  (''('''''''(''(('( '(  ('(''
'  !                                        !     ( ('''(('''''''''.            ''('''''''''''''('(''''('('((( !                 !  '''''       !   '(               (''(('('''(('' (  (    (* '
'  !                                        !         ( (''''(''''''$$$$$$$$$$$$''(('''''(''(( ''(((''''((''   !                 !  '''''       !   ''                '    ('''''(           ! '
'  !      -$$$$$$$$$$$$$$$$$$$$$$$$$$$$$$$& "            ('(''''('''''''''('''''''''''('((''(   '   ('' ( '    !                    ''''(       !   (                       '('''            ! '
'  !     -'''(''''''''(''''''''''''''''''   !                '((''('((''('''(''('('(''('('           '         ! #$$$$$$$$$$$$$$$$$$''('        !   (                       (''(             " '
'       -'''''(''(''('('''''''''(''''''('   "                 (   (   (' ( (((' (    '                         !    ''''''''''''''''''(         "                            '''             ! '
'$$$$$$$''(''( (''( (''(''('''('(''''('''   !                               (                                  !      '''''''''('''('(          !                            ('(             ! '
''''''''''((''   '   '('(''('(('('('(''''&  !                                                                  "      (''''''''''(''            !     #$&                                    ! '
''''''''''''(          '''('''   ''(((''('                                                                     !      '''''(''('( '(    #$$$$$&        '                             #$$$$$& ! '
(''''''''*'             '   '    '   '''''                                                                            '('''''(('          '(''                  #$$$$$$&              ''('   ! *
 '(''''('!                  '        '('''$$$$$$$$$$$$$$$$$$$$$$$$$$$$$$$$$$$$$$$$$$$$$$$$$$$$$$$$$$$$$$$$$$$$$$$$$$$$''''''''             '(                     '('(                 ''    ! !
 ''(''('(!                           (''('''''''''(''''''''''('''(''''''''''''''''''''''''''''''''''''''''''''''''''''''''(''                                     ( '                  '(    ! !
 ''''('' !                             (''('''('''''''('''('''''''('((''(*'''''''(''''''''''(''''''''''''''''''''''''''('( ('                                                                ! "
 '(''('' "                               (''('('''((('''('''('('(''' '''("''(''''''''('''('''''''' '('''''''(''('''(''(''(        +++++++++++++++++++++++++++           ++++++++++++         " !
  '''''' "                                '(   ('(  ( '(  '     ( '(  (  ! ' ('(''(''( '' (''(''(' (''''('(''('(''''(  '         +,,,,,,,,,,,,,,,,,,,,,,,,,,,+         +,,,,,,,,,,,,+        ! !
  '('''' !                                                               ! (   (  ( (  (    ( (      ('''('('(  (''(           #$%%%%%%%%%%%%%%%%%%%%%%%%%%%%%$$&     #%%%%%%%%%%%%%%&       ! !
   ''''( ! #$$$$$$$$$$$$$$$$$$$$$$$$$&                                   !                                       '               '''(''''''(''('''''('''('''''(         '''''('(''('           "
    '''' ! '''''''''''(''''(''''(''                                      "                                                         ( (''('(    ('('''('(' ('(            ('(    (''(           "
    '''' !  '''('''('(''(''((''(''                #$$&             #$$$& !                                                            (' (      (' (       (              '                    !
    (''' !  ('('''(''('(( '( ('                    ''++++++++       '''  !                                                                                                                     !
    '''' !     ('( '( '              +++++++++++++#'',,,,,,,,++++++#'''  !                                                                                                                     !
    '''( !                          +,,,,,,,,,,,,%'''%%,,,,,,,,%%%%''''                                                                                                                         
$$$$'''' !                        #$%%%%%%%%%%%%%''''''%%%%%%%%''''''''$$$$$$$$$$$$$$$$$$$$$$$$$$$$$$$$$$$$$$$$$$$$$$$$$$$$$$$$$$$$$$$$$$$$$$$$$$$$$$$$$$$$$$$$$$$$$$$$$$$$$$$$$$$$$$$$$$$$$$$$$
''''''(  !                         ''''''''''''''''''('''''(''''''''''''''''''''''''''''''''''''''''''''''''(''''''''''''''(''''''''''''''''''''''''''''''''''''''''''''''''''''''''''''''''''''
'''''(   "   ++++++++++++++++++++  ''''('''('('('''('('''(''('(''(''''''''''''''''''''''('(('''('(''''''''''''((''(('(''(''''''(('''''''('''(''''''('''('''''('''(''''''('''''(''''''''''''''''(
''('''   !  +,,,,,,,,,,,,,,,,,,,,+ ''(''''''''''''''''('''('''''''''''''''(('''''''''('''(  (('(    '''''''''''''''''''''(''''''''''(''''''(''''(''('''''('(''('(''''''''('''('''''('''('''''''(
(''''    ! #%%%%%%%%%%%%%%%%%%%%%%$''''''(''''''''''''''''' (('''('('''(((   (''('''''(('(             '''('''''''''''('('''('''(('''(( * (  '((    (('((  '((  ( '''(''(  (    '''(''''(''(''''
'''''    !   '''('''''''''(''''''''((''''''''''''''('''''            ((       ( '''((' (                 '''((''''''''''''('('''( ('(   !                         ('''((          '''('''''(''''
'''''    !    (''((''('('((''''''''''''''''''''''('''((                          ('                      (''''''''''('''''''   !        !                          '( (             ('('''('(''(
'''''    !     ('  (' ('( '('(''''(''''''(''''''''''(                                                     ''''('''''('''''(    !        "                          '(                  '''''''('
''(''    !                   '(''''''''''''('''''''                                                       '''''(''''(''''('    !        !                                              '('''''''
('(''    !                     '''(''''''('''('''''                                                       ''''''('''''''''(    "        ! #$$$$$$$$$$$$$$$$$$$$&                         '''''''
'''''    "                     '''''''''(''''''''''                                                       (''''''''''''''*     ! #$$$$& !   (''''''(*'(''''(''                           '''('''
''''(    !                     ''''('''(''''''''''(                                                        ''(''''''''''''     ! '''''' !    (''('( ! ('('('           #$$$$$$$$$$$$$$$'''*(   (
( ('     "                     '''''(''''''''''(''(                                                        ''(''('('''''''     ! (''''( !      '(   "   '('              '('''''''''''''' !     
         !                     ''''''(''''''''''''                           #$$$$$$$$$$$$$$$$$$$$$$$$$$$$$'''(('''(''''''     !   ''(              !                    (''''''((''''('( !     
         !                      ''''''('''''''''''                              (''''(('''''''''''''''''''''''''''('('''''$$$& !                    !                     ('('('' ('''(   "     
         !                        ((''''''''''''''$$$$$$$$$$$$$$$$$$$$$$$$$$$$&        (''''((''''(('''''''''''''''''('''(''(  !                    !                       ' ((   ('     !     
         "                           ('('''''(''(('''''''''''''''''''''''''''''$$$$$$&    (''''''''''''('''''      '( ('''((   !      #$$$$$$$$$$$& !                                     !     
         !                            ('''('( '  '''''''''''''''''''''''''''''''''(''      (''('( ''  ('           (    '(''   !       '('''''''''  "                                     ! #$. 
         !                     ++      ('''(  *   '''(''('''(''''''( '''''('( ((((('(        '(                          '''&  !         (''''''(   !                                     !  ''.
.                             +,,+      ''    !    '  (' ('''(''('(  * ('('(      (                                      * ''  "          ('('('                                          !  '''
