@@@@@@@@@@                     @@@@@@@@@@@@@@@@@@@@@@@@@@@@@@@@@@@@@@@@@@
$$$$$$$$$@                     @$$$$$$$$$$$$$$$$$$$$$$$$$$$$$$$$$$$$$$$$$
$$$$$$$$$@                     @$$$$$$$$$$$$$$$$$$$$$$$$$$$$$$$$$$$$$$$$$
$$$$$$$$$@@@@@@@@@@@@@@@@@@@@@@@$$$$$$$$$$$$$$$$$$$$$$$$$$$$$$$$$$$$$$$$$
$$$$$$$$$$$$$$$$$$$$$$$$$$$$$$$$$$$$$$$$$$$$$$$$$$$$$$$$$$$$$$$$$$$$$$$$$
$$$$$$$$$$$$$$$$$$$$$$$$$$$$$$$$$$$$$$$$$$$$$$$$$$$$$$$$$$$$$$$$$$$$$$$$$
$$$$$$$$$$$$$$$$$$$$$$$$$$$$$$$$$$$$$$$$$$$$$$$$$$$$$$$$$$$$$$$$$$$$$$$$$
$$$$$$$$$$$$$$$$$$$$$$$$$$$$$$$$$$$$$$$$$$$$$$$$$$$$$$$$$$$$$$$$$$$$$$$$$
$$$$$$$$$$$$$$$$$$$$$$$$$$$$$$$$$$$$$$$$$$$$$                        $$$$
$$$$$$$$$$$$$$$$$$$$$$$$$$$$$$$$$$$$$$$$$$$$$                        $$$$
$$$$$$$$$$$$$$$$$$$$$$$$$$$$$$$$$$$$$$$$$$$$$                        $$$$
$$$$$$$$$$$$$$$$$$$$$$$$$$$$$$$$$$$$$$$$$$$$$                        $$$$
$$$$$$$$$$$$$$$$$$$$$$$$$$$$$$$$$$$$$$$$$$$$$                        $$$$
$$$$$$$$$$$$$$$$$$$$$$$$$$$$$$$$$$$$ "                               $$$$
$$$$$$$$$$$$$$$$$$$$$$$$$$$$$$$$$$$$ !                               $$$$
$$$$$$$$$$$$$$$$$$$$$$$$$$$$$$$$$$$$ !                               $$$$
$$$$$$$$$$$$$$$$$$$$$$$$$$$$$$$$$$$$ "                               $$$$
$$$$$$$$$$$$$$$$$$$$$$$$$$$$$$$$$$$$ " ##############################$$$$
$$$$$$$$$$$$$$$$$$$$$$$$$$$$$$$$$$$$ " @@$$@@$$$$$$$$$$$$$$$$$$$$$$$$$$$$
$$$$$$$$$$$$$$$$$$$$$$$$$$$$$$$$$$$$ ! @@$$@@$$$$$$$$$$$$$$$$$$$$$$$$$$$$
$$$$$$$$                             " $$@@$$@@$$$$$$$$$$$$$$$$$$$$$$$$$$
$$$$$$$$                             " $$@@$$@@$$$$$$$$$$$$$$$$$$$$$$$$$$
$$$$$$$$                             ! @@$$@@$$@@$$@@$$$$$$$$$$$$$$$$$$$$
$$$$$$$$                             " @@$$@@$$@@$$@@$$$$$$$$$$$$$$$$$$$$
$$$$$$$$    $$@@@@                   ! $$@@$$@@$$$$$$$$$$$$$$$$$$$$$$$$$$
$$$$$$$$    $@@@@@                   " $$@@$$@@$$$$$$$$$$$$$$$$$$$$$$$$$$
$$$$$$$$    $@@@@@                   " @@$$@@$$$$$$$$$$$$$$$$$$$$$$$$$$$$
$$$$$$$$    $$@@@@                     @@$$@@$$$$$$$$$$$$$$$$$$$$$$$$$$$$
$$$$$$$$    $$$$$$#####################$$$$$$$$$$$$$$$$$$$$$$$$$$$$$$$$$$
$$$$$$$$    $$$$$$$$$$$$$$$$$$$$$$$$$$$$$$$$$$$$$$$$$$$$$$$$$$$$$$$$$$$$$
$$$$$$$$    $$$$$$$$$$$$$$$$$$$$$$$$$$$$$$$$$$$$$$$$$$$$$$$$$$$$$$$$$$$$$
$$$$$$$$    $$$$$$$$$$$$$$$$$$$$$$$$$$$$$$$$$$$$$$$$$$$$$$$$$$$$$$$$$$$$$
$$$$$$$$    $$$$$$$$$$$$$$$$$$$$$$$$$$$$$$$$$$$$$$$$$$$$$$$$$$$$$$$$$$$$$
$$$$$$$$    $$$$$$$$$$$$$$$$$$$$$$$$$$$$$$$$$$$@@@@@@@@@@@@@@@@@@@$$$$$$$
$$$$$$$$    $$$$$$$$$$$$$$$$$$$$$$$$$$$$$$$$$$$@                 @$$$$$$$
$$$$$$$$    $$$$$$$$$$$$$$$$$$$$$$$$$$$$$$$$$$$@                 @$$$$$$$
$$$$$$$@    @$$$$$$$$$$$$$@@@@@@@@@@@@@@@@@@@@@@                 @@@@@@@@
$$$$$$$@    @$$$$$$$$$$$$$@ "                                           @
$$$$$$$@    @$$$$$$$$$$$$$@ !                                           @
$$$$$$$@    @$$$$$$$$$$$$$@ "                                           @
$$$$$$$@    @$$$$$$$$$$$$$@ "                                           @
$$$$$$$@    @$$$$$$$$$$$$$@ " @@@@@@@@@@@@@@@@@@@@@@@@@@@@@@@@@@@@@@@   @
$$$$$$$@    @$$$$$$$$$$$$$@ ! @$$$$$$$$$$$$$$$$$$$$$$$$$$$$$$$$$$$$$@   @
$$$$$$$@    @$$$$$$$$$$$$$@ ! @$$$$$$$$$$$$$$$$$$$$$$$$$$$$$$$$$$$$$@   @
$$$$$$$@    @$$$$$$$$$$$$$@ " @$$$$$$$$$$$$$$$$$$$$$$$$$$$$$$$$$$$$$@   @
$$$$$$$@    @$$$$$$$$$$$$$@ ! @$$$$$$@@@@@@@@@@@@@@@@@@@@$$$$$$$$$$$@   @
$$$$$$$@    @$$$$$$$$$$$$$@ " @$$$$$$@                  @$$$$$$$$$$$@   @
$$$$$$$@    @$$$$$$$$$$$$$@ ! @$$$$$$@                  @$$$$$$$$$$$@   @
$$$$$$$@    @@@@@@@@@@@@@@@ " @$$$$$$@                  @$$$$$$$$$$$@   @
@@@@@@@@                    " @@@@@@@@                  @@@@@@@@@@$$@   @
                            !                                  ! @$$@    
                            "                                  ! @$$@    
                            "                                  " @$$@    
                                                               " @$$@    
@@@@@@@@@@@@@@@@@       @@@@@@@@@@@@@@@@@@@@@@@@@@@@@@@@@@@@@@ ! @$$@@@@@
$$$$$$$$$$$$$$$$@       @$$$$$$$$$$$$$$$$$$$$$$$$$$$$$$$$$$$$@ " @$$$$$$$
$$$$$$$$$$$$$$$$@       @$$$$$$$$$$$$$$$$$$$$$$$$$$$$$$$$$$$$@ " @$$$$$$$
$$$$$$$$$$$$$$$$@       @$$$$$$$$$$$$$$$$$$$$$$$$$$$$$$$$$$$$@ ! @$$$$$$$
$$$$$$$$$$$$$$$$@       @$$$$$$$$$$$$$$$$$$$$$$$$$$$$$$$$$$$$@ " @$$$$$$$
@@@@@@@@@@@@@@$$@       @$$@@@@@@@@@@@@@@@@@@@@@@@@@@@@@@@@@@@ " @@@@@@@@
             @$$@       @$$@                                   !         
             @$$@       @$$@                                   "         
             @@@@       @@@@                                   !         
                                                                         
